//wait	startindex	R,G,B Colors...
20	65	160,200,120	40,192,128	24,176,152	104,144,200
10	65	152,216,120	32,208,128	16,192,152	96,160,200
12	65	168,224,144	48,216,152	32,200,184	112,168,224
20	65	184,232,152	64,224,160	48,208,200	128,176,232
10	65	168,224,144	48,216,152	32,200,184	112,168,224
12	65	152,216,120	32,208,128	16,192,152	96,160,200
