//wait	startindex	R,G,B Colors...
19			60			176,0,0		232,32,0	248,88,0		248,128,16
18			60			192,0,0		240,40,0	248,104,8		248,144,56
17			60			200,0,0		248,48,0	248,112,8		248,152,64
16			60			208,8,0		248,64,0	248,120,24		248,160,80
16			60			216,8,0		248,80,0	248,120,32		248,168,88
16			60			232,8,0		248,88,0	248,144,40		248,176,96
17			60			240,8,0		248,88,0	240,160,48		248,184,104
18			60			248,16,0	248,112,0	248,168,72		248,192,104
19			60			248,32,0	248,144,8	248,192,104		248,216,112
18			60			248,16,0	248,144,8	248,184,88		248,208,112
17			60			240,8,0		248,88,0	240,160,48		248,184,104
16			60			232,8,0		248,88,0	248,144,40		248,176,96
16			60			216,8,0		248,80,0	248,120,32		248,168,88
17			60			208,8,0		248,64,0	248,120,24		248,160,80
18			60			192,0,0		248,48,0	248,112,8		248,152,64
